
2 2 2 2 2 2 2 2 2 2 2 2 2 2 2
0 0 0 0 0 0 0 0 0 0 0 0 0 0 0   
0 7 3 3 6 3 3 0 5 7 4 3 3 7 0
6 0 4 7 0 6 0 0 5 4 0 3 6 6 5
5 7 0 7 7 6 3 0 7 6 3 3 4 7 4
7 4 0 5 5 0 0 0 6 6 5 0 0 6 0
0 7 0 3 3 5 0 0 0 0 7 7 4 3 6
0 4 5 5 5 4 0 0 3 0 7 6 0 0 5
6 7 0 3 7 0 7 0 6 5 3 7 0 3 0
0 4 6 0 5 0 5 0 0 4 4 0 0 4 6
3 7 4 3 7 0 3 0 3 6 7 7 4 3 0
6 5 6 7 0 6 0 0 0 0 4 7 0 5 6
0 3 3 7 5 3 7 0 3 3 5 3 7 7 0 
0 0 5 5 4 6 7 0 3 4 0 5 4 0 0
2 2 2 2 2 2 2 2 2 2 2 2 2 2 2 